filename, language, Ruby, Markdown, Gemfile, slim-lang, SCSS, comment, blank, total
Gemfile, Gemfile, 0, 0, 16, 0, 0, 0, 2, 18
README.md, Markdown, 0, 0, 0, 0, 0, 0, 1, 1
assets/stylesheets/application.scss, SCSS, 0, 0, 0, 0, 9, 0, 0, 9
assets/stylesheets/buttons.scss, SCSS, 0, 0, 0, 0, 115, 0, 17, 132
assets/stylesheets/forms.scss, SCSS, 0, 0, 0, 0, 30, 0, 4, 34
assets/stylesheets/headers.scss, SCSS, 0, 0, 0, 0, 52, 0, 6, 58
assets/stylesheets/images.scss, SCSS, 0, 0, 0, 0, 19, 0, 2, 21
assets/stylesheets/messages.scss, SCSS, 0, 0, 0, 0, 35, 0, 4, 39
assets/stylesheets/popup.scss, SCSS, 0, 0, 0, 0, 47, 0, 2, 49
assets/stylesheets/queries.scss, SCSS, 0, 0, 0, 0, 23, 3, 5, 31
assets/stylesheets/utilities.scss, SCSS, 0, 0, 0, 0, 79, 0, 23, 102
config.ru, Ruby, 2, 0, 0, 0, 0, 0, 1, 3
lib/card_deck.rb, Ruby, 32, 0, 0, 0, 0, 0, 7, 39
lib/cpu.rb, Ruby, 14, 0, 0, 0, 0, 0, 4, 18
lib/game.rb, Ruby, 96, 0, 0, 0, 0, 1, 18, 115
lib/player.rb, Ruby, 39, 0, 0, 0, 0, 1, 10, 50
lib/playing_card.rb, Ruby, 25, 0, 0, 0, 0, 0, 6, 31
lib/results.rb, Ruby, 13, 0, 0, 0, 0, 0, 2, 15
server.rb, Ruby, 51, 0, 0, 0, 0, 0, 10, 61
sinatra-pusher.rb, Ruby, 0, 0, 0, 0, 0, 0, 1, 1
spec/models/card_deck_spec.rb, Ruby, 26, 0, 0, 0, 0, 0, 4, 30
spec/models/cpu_spec.rb, Ruby, 33, 0, 0, 0, 0, 0, 7, 40
spec/models/game_spec.rb, Ruby, 198, 0, 0, 0, 0, 1, 37, 236
spec/models/player_spec.rb, Ruby, 50, 0, 0, 0, 0, 0, 9, 59
spec/models/playing_card_spec.rb, Ruby, 35, 0, 0, 0, 0, 0, 7, 42
spec/models/results_spec.rb, Ruby, 8, 0, 0, 0, 0, 2, 2, 12
spec/models/server_spec.rb, Ruby, 0, 0, 0, 0, 0, 0, 1, 1
spec/system/integration_spec.rb, Ruby, 71, 0, 0, 0, 0, 0, 11, 82
views/game.slim, slim-lang, 0, 0, 0, 47, 0, 0, 0, 47
views/layout.slim, slim-lang, 0, 0, 0, 9, 0, 0, 0, 9
views/start.slim, slim-lang, 0, 0, 0, 13, 0, 0, 1, 14
Total, -, 693, 0, 16, 69, 409, 8, 204, 1399