filename, language, Ruby, Markdown, slim-lang, Gemfile, SCSS, comment, blank, total
Gemfile, Gemfile, 0, 0, 0, 16, 0, 0, 2, 18
README.md, Markdown, 0, 0, 0, 0, 0, 0, 1, 1
assets/stylesheets/application.scss, SCSS, 0, 0, 0, 0, 9, 0, 0, 9
assets/stylesheets/buttons.scss, SCSS, 0, 0, 0, 0, 115, 0, 17, 132
assets/stylesheets/forms.scss, SCSS, 0, 0, 0, 0, 30, 0, 4, 34
assets/stylesheets/headers.scss, SCSS, 0, 0, 0, 0, 74, 0, 9, 83
assets/stylesheets/images.scss, SCSS, 0, 0, 0, 0, 19, 0, 2, 21
assets/stylesheets/messages.scss, SCSS, 0, 0, 0, 0, 36, 0, 4, 40
assets/stylesheets/popup.scss, SCSS, 0, 0, 0, 0, 47, 0, 2, 49
assets/stylesheets/queries.scss, SCSS, 0, 0, 0, 0, 25, 3, 5, 33
assets/stylesheets/utilities.scss, SCSS, 0, 0, 0, 0, 87, 0, 25, 112
config.ru, Ruby, 2, 0, 0, 0, 0, 0, 1, 3
lib/card_deck.rb, Ruby, 35, 0, 0, 0, 0, 0, 8, 43
lib/cpu.rb, Ruby, 22, 0, 0, 0, 0, 0, 5, 27
lib/game.rb, Ruby, 107, 0, 0, 0, 0, 1, 20, 128
lib/player.rb, Ruby, 43, 0, 0, 0, 0, 1, 12, 56
lib/playing_card.rb, Ruby, 25, 0, 0, 0, 0, 0, 6, 31
lib/results.rb, Ruby, 13, 0, 0, 0, 0, 0, 2, 15
server.rb, Ruby, 52, 0, 0, 0, 0, 10, 12, 74
sinatra-pusher.rb, Ruby, 0, 0, 0, 0, 0, 0, 1, 1
spec/models/card_deck_spec.rb, Ruby, 48, 0, 0, 0, 0, 0, 9, 57
spec/models/cpu_spec.rb, Ruby, 38, 0, 0, 0, 0, 0, 8, 46
spec/models/game_spec.rb, Ruby, 241, 0, 0, 0, 0, 1, 45, 287
spec/models/player_spec.rb, Ruby, 50, 0, 0, 0, 0, 0, 9, 59
spec/models/playing_card_spec.rb, Ruby, 39, 0, 0, 0, 0, 0, 8, 47
spec/models/results_spec.rb, Ruby, 8, 0, 0, 0, 0, 2, 2, 12
spec/models/server_spec.rb, Ruby, 0, 0, 0, 0, 0, 0, 1, 1
spec/system/integration_spec.rb, Ruby, 63, 0, 0, 0, 0, 4, 12, 79
views/game.slim, slim-lang, 0, 0, 51, 0, 0, 0, 0, 51
views/layout.slim, slim-lang, 0, 0, 9, 0, 0, 0, 0, 9
views/start.slim, slim-lang, 0, 0, 13, 0, 0, 0, 1, 14
Total, -, 786, 0, 73, 16, 442, 22, 233, 1572